0,0,0,0,-1,0,0,0,0
0,100,0,0,-1,0,201,0,-1
0,0,0,0,1,0,0,0,0
0,101,0,0,1,0,0,0,-1
0,0,0,104,0,0,0,0,0
0,102,0,0,1,0,0,0,-1
0,0,0,0,1,0,0,0,0
0,103,0,0,-1,0,204,0,-1
0,0,0,0,-1,0,0,0,0