0,100,0,0,0,0,0,0,201
 0,0,0,0,0,0,1,0,-1
0,0,0,0,0,0,1,200,0
 0,0,0,1,0,0,1,0,-1
0,0,102,1,0,0,0,0,0
 0,0,0,1,0,0,1,0,-1
0,0,0,0,0,0,1,200,0
 0,0,0,0,0,0,1,0,-1
0,101,0,0,0,0,0,0,201