0,0,0,0,0,0,0,0,0
 1,0,1,0,1,0,1,0,-1
1,100,1,0,1,0,1,203,0
 1,0,1,0,1,0,1,0,-1
0,101,0,0,0,0,0,201,0
 0,1,0,1,0,1,0,1,-1
0,102,1,0,1,0,1,202,1
 0,1,0,1,0,1,0,1,-1
0,0,0,0,0,0,0,0,0