0,0,0,0,1,0,0,0,0
 0,0,0,1,1,0,0,0,-1
0,0,102,0,1,0,202,0,0
 0,0,0,1,1,0,0,0,-1
103,0,100,0,0,0,200,0,200
 0,0,0,1,1,0,0,0,-1
0,0,101,0,1,0,202,0,0
 0,0,0,1,1,0,0,0,-1
0,0,0,0,1,0,0,0,0