100,0,0,0,0,0,0,0,204
 0,0,1,0,0,1,0,0,-1
101,0,0,0,0,0,0,0,203
 0,0,1,0,0,1,0,0,-1
102,0,0,1,0,1,0,0,202
 0,0,1,0,0,1,0,0,-1
103,0,0,0,0,0,0,0,201
 0,0,1,0,0,1,0,0,-1
104,0,0,0,0,0,0,0,200