100,0,0,0,0,0,0,0,200
 0,1,0,1,0,1,0,1,0
101,1,0,1,0,1,0,1,204
 0,1,0,1,0,1,0,1,0
0,1,0,1,0,1,0,1,202
 0,1,0,1,0,1,0,1,0
102,1,0,1,0,1,0,1,204
 0,1,0,1,0,1,0,1,0
103,0,0,0,0,0,0,0,200