100,0,0,0,-1,0,0,0,0
 0,0,0,1,1,0,202,0,-1
0,0,0,0,1,0,201,0,0
 0,103,0,1,1,0,0,0,-1
0,0,0,0,0,0,200,0,0
 0,102,0,1,1,0,0,0,-1
0,0,0,0,1,0,201,0,0
 0,0,0,1,1,0,202,0,-1
101,0,0,0,-1,0,0,0,0