0,0,0,0,100,0,0,0,0
 0,1,1,0,0,1,1,0,-1
0,1,0,0,0,0,0,1,0
 0,0,0,1,1,0,0,0,-1
0,200,1,0,202,0,1,200,0
 0,0,0,1,1,0,0,0,-1
0,1,0,0,0,0,0,1,0
 0,1,1,0,0,1,1,0,-1
0,0,101,0,0,0,102,0,0