-1,-1,0,0,0,0,0,-1,-1
 -1,0,101,0,0,204,0,-1,-1
-1,0,0,0,1,0,0,0,-1
 -1,0,0,0,0,0,0,-1,-1
-1,0,100,0,1,0,200,0,-1
 -1,0,0,0,0,0,0,-1,-1
-1,0,0,0,1,0,0,0,-1
 -1,0,102,0,0,202,0,-1,-1
-1,-1,0,0,0,0,0,-1,-1