0,0,1,0,0,0,0,0,0
 0,100,1,0,0,1,0,0,0
0,0,1,0,0,0,1,201,0
 0,0,0,1,0,1,0,1,0
0,101,0,1,0,0,0,1,203
 0,0,0,1,0,1,0,1,0
0,0,1,0,0,1,204,0,0
 0,102,1,0,0,1,0,0,0
0,0,1,0,0,0,0,0,0