0,0,0,0,204,0,-1,0,0
 0,0,1,0,0,1,0,0,-1
0,0,101,1,0,1,203,0,0
 -1,1,1,0,0,1,1,0,-1
103,0,0,0,-1,0,0,0,100
 0,1,1,0,0,1,1,-1,-1
0,0,203,1,0,1,102,0,0
 0,0,1,0,0,1,0,0,-1
0,0,-1,0,201,0,0,0,0