0,0,0,0,0,-1,0,0,0
 0,0,101,1,0,0,1,0,-1
0,0,1,1,200,1,1,102,0
 1,0,200,1,0,200,1,0,-1
1,0,1,0,203,1,0,0,0
 1,103,1,1,0,1,1,0,-1
0,0,1,0,200,1,100,0,0
 0,0,0,1,0,0,-1,0,-1
0,-1,0,0,0,1,0,0,0