0,0,0,0,0,0,0,0,0
0,0,0,0,0,0,0,0,-1
0,0,0,0,0,0,0,0,0
0,0,0,1,1,0,0,0,-1
0,100,0,0,1,0,0,200,0
0,0,0,1,1,0,0,0,-1
0,0,0,0,-1,0,0,0,0
0,0,0,0,-1,0,0,0,-1
0,0,103,0,-1,0,0,0,0