0,0,0,0,0,0,0,0,0
 0,100,1,0,0,1,201,0,-1
0,0,0,0,0,0,0,0,0
 0,0,1,0,0,1,0,0,-1
0,102,0,1,0,1,0,200,0
 0,0,1,0,0,1,0,0,-1
0,0,0,0,0,0,0,0,0
 0,100,1,0,0,1,201,0,-1
0,0,0,0,0,0,0,0,0